31 31 31 31 31 31 31 31 31 31 31 31 31 31 31 31 31 31 31 31 31 31 31 31 31 31 31 31 31 31 31 31 31 31 31 31 31 31 31 31 31 31 31 31 31 31 31 31 31 31
31 31 31 31 31 31 31 31 31 31 31 31 31 31 31 31 31 31 31 31 31 31 31 31 31 31 31 31 31 31 31 31 31 31 31 31 31 31 31 31 31 31 31 31 31 31 31 31 31 31
05 05 05 05 05 05 05 05 05 05 05 05 05 05 05 05 05 05 05 05 05 05 05 05 05 05 05 05 05 05 05 05 05 05 05 05 05 05 05 05 05 05 05 05 05 05 05 05 05 05
05 05 05 05 05 05 05 05 05 05 05 05 05 05 05 05 05 05 05 05 05 05 05 05 05 05 05 05 05 05 05 05 05 05 05 05 05 05 05 05 05 05 05 05 05 05 05 05 05 05
05 05 05 05 05 05 05 05 05 05 05 05 05 05 05 05 05 05 05 05 05 05 05 05 05 05 05 05 05 05 05 05 05 05 05 05 05 05 05 05 05 05 05 05 05 05 05 05 05 05
05 05 05 05 05 05 05 05 05 05 05 05 05 05 05 05 05 05 05 05 05 05 05 05 05 05 05 05 05 05 05 05 05 05 05 05 05 05 05 05 05 05 05 05 05 05 05 05 05 05
05 05 05 05 05 05 05 05 05 05 05 05 05 05 05 05 05 05 05 05 05 05 05 05 05 05 05 05 05 05 05 05 05 05 05 05 05 05 05 05 05 05 05 05 05 05 05 05 05 05
05 05 05 05 05 05 05 05 05 05 05 05 05 05 05 05 05 05 05 05 05 05 05 05 05 05 05 05 05 05 05 05 05 05 05 05 05 05 05 05 05 05 05 02 00 02 05 05 05 05
05 05 05 05 05 05 05 05 05 05 05 05 05 05 05 05 05 05 05 05 05 05 05 05 05 05 03 03 03 03 03 03 05 05 05 05 05 05 05 05 05 05 05 03 01 03 05 05 05 05
05 05 05 05 05 05 05 05 05 05 05 05 05 05 05 05 05 05 05 05 05 05 05 05 05 02 02 02 02 02 02 02 22 31 31 31 31 31 31 31 25 05 05 05 00 05 05 05 05 05
05 05 05 05 05 05 05 05 05 05 05 05 05 05 05 05 05 05 05 05 05 05 05 05 05 02 21 02 02 02 02 02 32 54 54 54 54 54 54 54 23 31 31 29 00 30 05 05 05 05
05 05 05 05 05 05 05 05 05 05 05 05 05 05 05 05 05 05 05 05 05 05 05 05 05 02 02 02 02 02 02 02 32 53 53 53 53 53 53 53 48 51 52 48 53 32 05 05 05 05
05 05 05 05 05 05 05 05 05 05 05 05 05 40 39 41 05 05 05 05 05 05 05 05 05 05 03 03 03 03 00 00 32 53 53 53 53 53 53 53 53 53 53 53 53 32 05 05 05 05
05 05 05 05 05 05 05 05 05 05 05 40 39 35 45 34 41 05 05 05 05 05 05 05 05 05 05 05 05 05 00 00 32 54 54 54 53 53 47 47 53 53 53 53 53 32 05 05 05 05
05 05 05 05 05 05 05 05 05 05 05 37 44 45 45 44 38 05 05 05 05 05 05 05 05 05 05 05 05 05 00 00 32 53 53 53 53 53 49 50 22 31 31 31 31 24 00 05 05 05
05 05 05 05 05 05 05 05 05 05 05 42 33 44 45 46 43 05 05 05 05 05 05 05 05 05 05 05 05 05 01 00 23 25 53 53 53 53 53 53 32 00 00 00 00 00 00 05 05 05
05 05 05 05 05 05 05 05 05 05 05 05 42 36 36 43 00 00 05 05 05 05 05 05 05 05 05 05 05 00 00 00 00 23 31 29 53 27 31 31 24 03 00 01 00 00 00 05 05 05
05 05 05 05 05 05 05 05 05 05 05 05 02 00 55 00 00 03 00 05 05 05 05 05 05 05 05 05 01 00 00 01 00 00 00 02 00 02 00 00 00 00 00 00 00 00 00 05 05 05
05 05 05 05 05 05 05 05 05 05 05 02 00 00 00 00 00 01 00 18 19 19 19 08 05 05 06 20 00 00 00 00 00 00 00 00 00 00 01 00 00 00 00 00 00 00 00 05 05 05
05 05 05 05 05 05 05 05 05 05 05 00 00 00 01 00 00 00 00 05 05 05 05 13 05 05 13 05 00 00 00 00 00 01 00 00 00 00 00 00 00 00 00 00 00 00 00 05 05 05
05 05 05 05 05 05 05 05 05 05 05 05 00 03 00 00 00 00 05 05 05 05 05 13 05 05 13 05 00 00 01 00 00 00 00 00 00 00 05 05 00 00 01 00 00 01 00 05 05 05
05 05 05 05 05 05 05 05 05 05 05 05 05 05 09 05 05 05 05 05 05 05 05 13 05 05 13 05 01 00 00 00 00 00 00 00 01 05 05 05 05 05 05 00 00 56 00 05 05 05
05 05 05 05 05 01 01 00 00 00 00 05 05 05 13 05 05 05 05 05 05 05 05 10 19 19 16 05 05 00 00 00 00 01 00 00 00 00 05 05 05 05 05 05 00 00 00 05 05 05
05 05 05 05 02 00 00 00 00 01 00 18 19 19 16 05 05 05 05 05 05 05 05 13 05 05 05 05 05 00 03 00 00 00 00 00 00 00 57 00 05 05 00 02 00 01 00 05 05 05
05 05 05 05 02 00 00 01 03 03 03 05 05 05 05 05 05 05 05 00 05 05 05 13 05 05 05 05 05 00 00 00 00 00 02 00 01 00 57 00 00 00 00 00 00 00 00 05 05 05
05 05 05 05 05 01 00 00 03 03 03 05 05 05 05 05 05 05 05 00 05 05 05 13 05 05 05 05 05 05 05 00 00 00 00 00 00 57 00 00 03 00 00 01 00 00 00 05 05 05
05 05 05 05 05 05 05 05 03 03 03 05 05 05 05 05 05 05 05 00 02 00 05 13 05 00 00 01 05 05 05 05 05 05 05 00 00 57 00 00 00 00 00 00 00 00 00 05 05 05
05 05 05 05 05 05 05 05 05 05 05 05 05 05 05 05 05 05 05 05 05 00 05 17 05 02 05 00 05 05 05 05 05 05 05 05 05 05 05 05 05 05 05 02 00 02 05 05 05 05
05 05 05 05 05 05 05 05 05 05 05 05 05 05 02 02 02 00 00 00 00 01 05 00 00 01 05 00 00 00 00 02 05 05 05 05 05 05 05 05 05 05 05 03 00 03 05 05 05 05
05 05 05 05 05 05 05 05 05 05 05 05 05 05 05 05 05 05 05 00 05 00 05 00 05 05 05 00 05 05 05 05 05 05 05 05 05 05 05 05 05 05 05 03 09 03 05 05 05 05
05 05 05 05 05 05 05 05 05 05 05 05 05 05 00 01 21 56 00 00 05 00 05 00 01 00 05 00 05 03 03 03 05 05 05 05 05 05 05 05 05 05 05 05 13 05 05 05 05 05
05 05 05 05 05 05 05 05 05 05 05 05 05 05 00 05 05 05 05 05 05 01 05 00 05 00 05 00 05 03 00 03 18 19 19 19 19 19 19 19 19 19 19 19 16 05 05 05 05 05
05 05 05 05 05 05 05 05 05 05 05 05 05 05 00 00 02 01 05 00 00 00 02 01 05 00 05 01 05 03 03 03 05 05 05 05 05 05 05 05 05 05 05 05 05 05 05 05 05 05
05 05 05 05 05 05 05 05 05 05 05 05 05 05 05 05 05 00 05 05 05 05 05 05 05 05 05 00 05 05 05 05 05 05 02 05 05 05 05 05 05 05 05 05 05 05 05 05 05 05
05 05 05 05 05 05 05 05 05 05 05 05 05 05 05 05 05 00 00 00 00 00 01 00 00 00 01 00 00 05 00 00 00 00 00 05 05 05 05 05 05 05 05 05 05 05 05 05 05 05
05 05 05 05 05 05 05 05 05 05 05 05 05 05 05 05 05 05 05 05 05 05 00 05 05 05 05 00 05 05 00 05 05 05 05 05 05 05 05 05 05 05 05 05 05 05 05 05 05 05
05 05 05 05 05 05 05 05 05 05 05 05 05 05 05 05 05 05 05 05 05 06 19 08 05 05 05 00 00 00 00 05 05 05 05 05 05 05 05 05 05 05 05 05 05 05 05 05 05 05
05 05 05 05 05 05 05 05 05 05 05 05 05 05 05 05 05 05 05 05 05 13 00 13 05 00 00 00 05 05 05 05 05 05 05 05 05 05 05 05 05 05 05 05 05 05 05 05 05 05
05 05 05 05 05 05 05 05 05 05 05 05 05 05 05 05 05 05 05 05 05 14 19 16 05 05 05 05 05 05 05 05 05 05 05 05 05 05 05 05 05 05 05 05 05 05 05 05 05 05
05 05 05 05 05 05 05 05 05 05 05 05 05 05 05 05 05 05 05 05 05 05 05 05 05 05 05 05 05 05 05 05 05 05 05 05 05 05 05 05 05 05 05 05 05 05 05 05 05 05
05 05 05 05 05 05 05 05 05 05 05 05 05 05 05 05 05 05 05 05 05 05 05 05 05 05 05 05 05 05 05 05 05 05 05 05 05 05 05 05 05 05 05 05 05 05 05 05 05 05
05 05 05 05 05 05 05 05 05 05 05 05 05 05 05 05 05 05 05 05 05 05 05 05 05 05 05 05 05 05 05 05 05 05 05 05 05 05 05 05 05 05 05 05 05 05 05 05 05 05
05 05 05 05 05 05 05 05 05 05 05 05 05 05 05 05 05 05 05 05 05 05 05 05 05 05 05 05 05 05 05 05 05 05 05 05 05 05 05 05 05 05 05 05 05 05 05 05 05 05
05 05 05 05 05 05 05 05 05 05 05 05 05 05 05 05 05 05 05 05 05 05 05 05 05 05 05 05 05 05 05 05 05 05 05 05 05 05 05 05 05 05 05 05 05 05 05 05 05 05
05 05 05 05 05 05 05 05 05 05 05 05 05 05 05 05 05 05 05 05 05 05 05 05 05 05 05 05 05 05 05 05 05 05 05 05 05 05 05 05 05 05 05 05 05 05 05 05 05 05
05 05 05 05 05 05 05 05 05 05 05 05 05 05 05 05 05 05 05 05 05 05 05 05 05 05 05 05 05 05 05 05 05 05 05 05 05 05 05 05 05 05 05 05 05 05 05 05 05 05
31 31 31 31 31 31 31 31 31 31 31 31 05 05 05 05 05 05 05 05 05 05 05 05 05 05 05 05 05 05 05 05 05 05 05 05 31 31 31 31 31 31 31 31 31 31 31 31 31 31
31 31 31 31 31 31 31 31 31 31 31 31 31 31 31 31 31 31 31 31 31 31 31 31 31 31 31 31 31 31 31 31 31 31 31 31 31 31 31 31 31 31 31 31 31 31 31 31 31 31
31 31 31 31 31 31 31 31 31 31 31 31 31 31 31 31 31 31 31 31 31 31 31 31 31 31 31 31 31 31 31 31 31 31 31 31 31 31 31 31 31 31 31 31 31 31 31 31 31 31
31 31 31 31 31 31 31 31 31 31 31 31 31 31 31 31 31 31 31 31 31 31 31 31 31 31 31 31 31 31 31 31 31 31 31 31 31 31 31 31 31 31 31 31 31 31 31 31 31 31